###############
#      @      #
#    b   b    #
# #         ###
# #    b    # #
# #    b    # #
# #    b    # #
# #    b    # #
#a#    b    # #
###h   b    # #
#             #
#  v        b #
######   ######
#      x    o*#
###############
