###############
#      @      #
#    b   b    #
# #         ###
# #    b    # #
# #    b    # #
# #    b    # #
# #    b    # #
#a#aaa b    # #
###haa b    # #
# aaaa        #
#  v        b #
######   ######
#      x    o*#
###############
